1111111111111111111111111111111111
10P0000000000000C00000C00000000001
1011110100100000101001000000010101
1011110010101010001001000000010101
100000000C00C000000000001C10000001
1011110100100000101001000000010101
1011110010101010001001000000010101
1011110100100000101001000000010101
1011110010101010001001001111110101
1011110100100000101001001000C10101
1011110010101010001001000000010111
1111111111111111111111111111111111